[
    [0,0,0,0,0,0,0,0,0,0,0,0,0,0,0,0,0,0,0,0,0,0,0,0,0,0,0,0,0,0,0,0,0,0,0,0,0,0,0,0,0,0,0,0,0,0,0,0],
    [0,1,1,1,1,1,1,1,1,1,1,1,1,1,1,1,1,1,1,0,0,0,0,0,0,0,0,1,1,1,1,1,1,1,1,1,1,1,1,12,0,0,1,0,0,0,0,0],
    [0,1,12,12,12,1,12,12,12,1,12,12,12,12,12,12,12,12,1,18,18,18,18,18,18,18,18,18,17,17,17,17,17,17,17,17,17,17,1,8,12,12,1,12,0,0,0,0],
    [0,1,12,1,1,1,12,1,12,1,1,12,1,1,1,12,12,12,1,18,18,18,18,18,18,18,18,18,17,17,17,17,17,17,17,17,17,17,1,4,7,7,1,12,12,0,0,0],
    [0,1,12,1,12,12,12,1,12,12,12,12,1,1,1,1,1,1,1,18,18,0,0,0,0,0,18,17,17,17,1,17,17,17,17,1,17,17,2,7,7,7,1,8,12,0,0,0],
    [0,1,12,1,12,1,1,1,1,1,1,1,1,1,1,12,12,12,12,12,18,0,1,1,0,1,1,1,17,17,1,17,17,1,1,1,17,6,6,7,7,7,1,1,1,1,1,0],
    [0,1,12,12,12,12,12,1,12,12,12,12,12,12,12,12,12,12,12,12,12,0,1,0,0,12,12,1,17,17,17,17,17,17,17,17,17,6,6,19,7,7,3,6,10,12,0,0],
    [0,1,1,1,1,1,12,1,12,12,12,12,12,12,12,12,9,6,8,12,19,12,1,0,12,12,12,1,17,17,17,17,6,6,6,6,6,4,7,7,3,6,6,10,12,0,0,0],
    [0,1,12,12,12,1,12,1,12,12,12,12,1,1,1,12,6,6,6,12,12,12,1,12,12,9,6,1,17,17,1,6,4,7,7,7,7,7,7,3,6,10,12,12,12,0,0,0],
    [0,1,12,1,1,1,12,1,12,12,12,12,1,1,1,12,6,1,1,1,1,1,1,1,1,1,1,1,17,17,1,7,7,3,6,1,1,1,1,1,1,1,12,12,12,0,0,0],
    [0,1,12,1,12,12,12,1,1,1,12,12,1,1,1,12,6,1,17,17,17,17,17,17,17,17,17,1,17,17,1,1,1,1,1,1,12,12,12,0,12,12,12,0,12,0,0,0],
    [0,1,12,1,12,1,1,1,12,12,12,12,12,1,12,12,6,1,17,17,6,17,17,17,17,17,17,17,17,17,1,12,12,12,0,0,0,0,0,0,0,12,0,0,12,0,0,0],
    [0,1,12,1,12,1,12,12,12,12,12,12,12,1,12,12,6,1,17,6,6,17,1,17,17,17,17,17,17,17,1,12,0,0,0,0,0,0,0,0,0,0,0,0,0,0,0,0],
    [0,1,12,1,12,1,12,1,12,12,12,12,12,1,12,12,6,1,4,5,1,1,1,1,1,1,1,1,6,17,1,1,1,0,0,0,0,0,0,0,0,0,0,0,0,0,0,0],
    [0,1,12,12,12,12,12,1,1,1,1,1,1,1,12,9,6,1,7,7,17,17,1,17,17,17,17,1,6,17,8,12,12,12,0,0,0,0,0,0,0,0,0,0,0,0,0,0],
    [0,1,1,1,1,1,1,1,9,6,6,8,12,12,9,6,6,1,7,7,5,17,17,17,15,16,17,17,6,6,6,6,8,12,12,0,0,0,0,0,0,0,0,0,0,0,0,0],
    [0,0,0,12,12,12,12,9,4,7,7,5,6,6,6,4,5,1,1,1,2,5,17,17,13,14,17,17,17,6,1,1,1,8,12,12,12,0,0,0,0,0,0,0,0,0,0,0],
    [0,0,0,12,12,9,6,6,7,7,7,7,7,7,7,7,7,7,6,1,17,2,1,17,17,17,17,1,6,6,1,1,1,6,6,8,12,12,0,0,0,0,0,0,0,0,0,0],
    [0,0,0,12,12,6,6,4,7,7,7,7,7,7,7,7,7,7,6,1,17,17,1,1,1,1,1,1,4,5,1,1,1,6,6,6,8,12,12,0,0,0,0,0,0,0,0,0],
    [0,0,0,0,12,6,6,1,1,2,3,17,1,1,7,7,19,7,5,1,17,6,1,6,6,1,14,17,7,7,7,5,6,6,6,6,6,8,12,0,0,0,0,0,0,0,0,0],
    [0,0,0,0,12,11,6,1,17,17,6,17,13,1,6,2,7,7,7,5,6,6,4,5,6,1,17,7,7,7,7,7,7,7,5,6,6,6,12,12,0,0,0,0,0,0,0,0],
    [0,0,0,0,0,12,6,1,17,17,17,17,17,1,6,6,7,7,7,7,7,7,7,3,6,1,17,6,2,7,7,7,1,7,7,6,6,6,12,12,0,0,0,0,0,0,0,0],
    [0,0,0,0,1,1,1,1,17,17,17,17,17,1,1,1,1,1,1,1,1,1,1,1,1,1,17,17,1,1,1,1,1,2,7,19,6,10,12,12,12,0,0,0,0,0,0,0],
    [0,0,0,0,1,14,17,17,17,17,17,17,17,17,17,17,17,17,17,17,17,17,17,17,17,17,17,17,1,14,17,6,6,6,7,5,6,12,12,12,12,0,0,0,0,0,0,0],
    [0,0,0,0,1,17,17,17,17,17,17,17,17,17,17,17,17,17,17,17,17,1,17,17,17,17,17,15,1,17,17,17,17,17,2,7,5,8,12,12,12,0,0,0,0,0,0,0],
    [0,0,0,0,1,17,17,15,16,17,17,15,16,17,17,17,1,17,1,1,1,1,17,1,17,17,1,1,1,1,1,17,17,1,1,1,1,10,12,12,12,0,0,0,0,0,0,0],
    [0,0,0,0,1,17,17,13,19,16,17,13,19,16,17,17,1,16,17,17,17,17,15,1,17,17,17,17,17,17,17,17,17,1,17,13,1,12,12,12,12,0,0,0,0,0,0,0],
    [0,0,0,0,1,17,17,17,13,14,17,17,13,14,17,17,1,1,1,1,1,1,1,1,17,19,17,17,17,17,17,17,17,17,17,17,1,1,1,1,1,0,0,0,0,0,0,0],
    [0,0,0,0,1,17,17,17,17,17,17,17,17,17,17,17,1,12,12,12,12,12,12,1,16,17,17,1,1,1,1,16,17,17,17,15,1,12,12,12,0,0,0,0,0,0,0,0],
    [0,0,0,0,1,16,17,17,17,17,17,17,17,17,17,17,1,12,12,12,12,12,12,1,1,1,1,1,12,12,1,1,1,1,1,1,1,12,12,12,0,0,0,0,0,0,0,0],
    [0,0,0,0,1,1,1,1,1,1,1,1,1,1,1,1,1,0,0,0,0,0,12,12,12,12,12,12,12,12,12,12,12,12,12,12,12,12,0,0,0,0,0,0,0,0,0,0],
    [0,0,0,0,0,0,0,0,0,0,0,0,0,0,0,0,0,0,0,0,0,0,0,0,0,0,0,0,0,0,0,0,0,0,0,0,0,0,0,0,0,0,0,0,0,0,0,0]
]